NO   ./textures/brain_coral_block.xpm              
SO   ./textures/jukebox_side.XPM        
WE   ./textures/copper_ore.XPM              
EA   ./textures/crimson_stem_top.XPM              
F   220  , 100,  0
C     225   ,30,  0
1111111111111111111111111
1000000000110000000000001
1011000001110000000000001
1001000000000000000000001
111111111011000001110000000000001
100000000011000001111111111111111
11110111111111111100000010001
11111111111111011101010010001
11000000110101011100000010001
10000000000000000000000000001
10000000000000001101010010001
11000001110101011111011110E0111
11110111011101010101111010001
11111111011111110111111111111

