NO   ./textures/brain_coral_block.XPM              
SO   ./textures/jukebox_side.XPM        
WE   ./textures/copper_ore.XPM              
EA   ./textures/crimson_stem_top.XPM              
F   220  , 100,  0
C     225   ,30,  0





        111111111111111111111111111
1111111111110110000011100000000000
11001000000000000000000001111111111
11111111110110000011100000000000011
11000000000110000011111111111111111
11111011111111110000000000000100011
111111111111111011101010010001111
111    101101010111000000100011
11   0  010000000000000000000011
1  0 S   1000000000011010100100011
111   11110101011111011110001111 
1111111111111111111111111111111


