NO   ./textures/brain_coral_block.XPM               
   SO   ./textures/jukebox_side.XPM  
  WE   ./textures/copper_ore.XPM   
EA   ./textures/crimson_stem_top.XPM   
    
	F   0  , 52,      
    C     6   ,144,  16

       1111111111101111111111
       10010000011100000000011111
       1100000000000000000000000111
11111111110110000011100000000000011
11000000000110000011111111011111111
11111011111111110000000000000100011
111111111111111011101010010001111
1110000001101010111000000100011
1100000000000000000000000000011
10000000000000000011010100100011
111000001110101011111011110E01111
1111111111111111111111111111111




