NO   ./textures/brain_coral_block.XPM              
SO   ./textures/jukebox_side.XPM    
WE   ./textures/copper_ore.XPM         
EA   ./textures/crimson_stem_top.XPM         

F   0  , 100,  200
C     88   ,20,  1

          11111111111           1111111111
          10000010001    11111111000000001
11111111   1000001111    10000100001111111
100000011111111000001111111000000111111
10000001    100000000000000000000001
1000000111111111110111111110000001111
10000010001      101      11100000001
10000000001      101      10000000001
11111100001      101       1000011111
    11100011111111011111111000111
       101100000110000000000001111
       1100100000000000000000000111
11111111110110000011100000000000011
11000000000110000011111111011111111
11111011111111110000000000000100011
111111111111111011101010010001111
1110000001111010111000000100011
1100000001 100000000000000000011
1000000001 1000001101S10010001111
1110100011101010111110111100000001111
1001 10000111111111111111100000111001
1001 100000000000000000000000001 1001
1111 111111111111111111111111111 111
